1111111111111
1C010E000E001
100C011111001
100011E00P001
1111111111110