1111111111111111111111
1000C0000010000000C001
100000000000C000000001
10000000100000C0001001
1010001000000000000001
1000C000101010100C0001
100000001C00001000C001
10101010000100C0101001
1000100010001010000001
1000C00010101000000PE1
1111111111111111111111